10 10
 *   *****
 * *      
 * * **** 
 * ****** 
   *  *   
** * *  * 
 * * * *  
     * ***
**** *   *
     */***