  *******************
      *     *       *
*** ******* ******* *
*     *   * *     * *
* ******* * *** * * *
*   * *   *     * * *
* *** *** * * ***** *
*         * * * *   *
* * ******* *** * * *
* *               * *
*** * *** * ******* *
* * * *   *   *   * *
* * * ******* * * ***
*   * * *   *   *   *
* ***** * ******* * *
* *   *       *   * *
* * * * *** *** * * *
*   *   * * * * * * *
* *** * * * * * * * *
* *   *   *   * * * *
*******************/*