21 21
  *******************
* * * *   * *   *   *
* * * *** * *** *** *
* * *   * *   *     *
* * * * * * ***** * *
*     *   *   *   * *
* ********* * * * ***
*           * * *   *
* ********* ******* *
*   *   *     *     *
* * * ******* *** ***
* * * * *   *   *   *
*** * * * *** * * ***
*   * * *     * *   *
*** * * ***** *** * *
*     * * * *     * *
* *** * * * *** *** *
* * * * *   * * * * *
* * * * *** * *** * *
* *       *         /
****/**************/*