21 21
 ******************/*
        *       *   *
*** ***** ******* * *
*         *       * *
*** * *** ***** *** *
* * * * * * * * *   *
* *** * *** * * *** *
*   *   *     * *   *
*** * ***** ******* *
*         * * *     *
******* * * * *** * *
*     * *   *     * *
***** ***** * * *** *
/         *   * *   *
* * ***** * * *******
* * * *     *       *
* *** ***** * ***** *
*   *   *   * * *   *
* ***** * * * * * ***
*   *     * *   *   *
*******************/*