9 9
 ********
        *
* *******
*     * *
*** *** *
* *     *
* * *** *
*     * *
******* *