9 9
 ****/***
        *
* *******
*     * *
*** *** *
* *     /
* * *** *
*     * *
*/*******