25 25
  ***********************
        *           *   *
*** * ***** * *** ***** *
*   * * *   * *   * *   *
*** *** ********* * * ***
*   * *   *     *   *   *
* * * * *** *** * * * ***
* * *       *   * * * * *
*** ***** ***** * * * * *
* *       *       *     *
* * ******* *** ***** * *
* * * *   *   * * *   * *
* * * * * * *** * * * * *
* *   * * * * *   * * * *
* *** *** *** *** * *** *
*   * *     *     *   * *
* ******* * ***** * *****
*   *   * *   *   *   * *
*** * *** *** *** *** * *
* * *     *   *   * * * *
* * *** *** * *** * * * *
*       *   *     * * * *
* ***** * *** ***** *** *
*   *   *   *           /
*************************