15 15
  *************
  * *   *    /*
* * * * * * ***
* * * * * * * *
* * * *** *** *
* *       * * *
* * * * * * * *
*   * * * *   *
* ********* * *
* *   *     * *
* * * ******* *
*   * *       *
* * * * * *****
* * *   *    /*
*************** 