13 13
  ***********
    * * */  *
*** * * *** *
*   *       *
* * ***** * *
* * *     * *
* ******* * *
*       * * *
***** ***** *
*         * *
* * *** *** *
* * *        
*************